10 80
0 0 0 0 0 0 0 0 0 0 0 0 0 0 0 0 0 0 0 0 0 0 0 0 0 0 0 0 0 0 0 0 0 0 0 0 0 0 0 0 0 0 0 0 0 0 0 0 0 0 0 0 0 0 0 0 0 0 0 0 0 0 0 0 0 0 0 0 0 0 0 0 0 0 0 0 0 0 0 0 
0 0 0 0 0 0 0 0 0 0 0 0 0 0 0 0 0 0 0 0 0 0 0 0 0 0 0 0 0 0 0 0 0 0 0 0 0 0 0 0 0 0 0 0 0 0 0 0 0 0 0 0 0 0 0 0 0 0 0 0 0 0 0 0 0 0 0 0 0 0 0 0 0 0 0 0 0 0 0 0 
0 0 0 0 0 0 0 0 0 0 0 0 0 0 0 0 0 0 0 0 0 0 0 0 0 0 0 0 0 0 0 0 0 0 0 0 0 0 0 0 0 0 0 0 0 0 0 0 0 0 0 0 0 0 0 0 0 0 0 0 0 0 0 0 0 0 0 0 0 0 0 0 0 0 0 0 0 0 0 0 
0 0 0 0 0 0 0 0 0 0 0 0 0 0 0 0 0 0 0 0 0 0 0 0 0 0 0 0 0 0 0 0 0 0 0 0 0 0 0 0 0 0 0 0 0 0 0 0 0 0 0 0 0 0 0 0 0 0 0 0 0 0 0 0 0 0 0 0 0 0 0 0 0 0 0 0 0 0 0 0 
0 0 0 0 0 0 0 0 0 0 0 0 0 0 0 0 0 0 0 0 0 0 0 0 0 0 0 0 0 0 0 0 0 0 0 0 1 2 2 2 2 2 3 0 0 0 0 0 0 0 0 0 0 0 0 0 0 1 3 0 0 0 0 0 0 0 0 0 0 0 0 0 0 0 0 0 0 0 0 0 
0 0 0 0 0 0 0 1 2 2 2 2 2 3 0 0 0 0 0 0 0 0 0 0 0 0 0 0 0 0 0 0 0 0 0 0 11 12 9 9 9 12 13 0 0 0 0 0 0 0 0 0 0 0 1 3 0 8 10 0 1 3 0 0 0 0 0 0 0 0 0 0 0 0 0 0 0 0 0 0 
0 0 0 0 0 0 0 11 12 9 9 9 12 13 0 0 0 0 0 0 0 0 0 0 0 0 0 1 2 2 2 2 2 3 0 0 0 0 8 9 10 0 0 0 0 0 0 0 0 0 0 1 3 0 8 10 0 11 13 0 8 10 0 0 1 3 0 0 0 0 0 0 0 0 0 0 0 0 0 0 
0 0 0 0 1 3 0 0 0 8 9 10 0 0 0 0 0 1 2 2 2 2 2 3 0 0 0 11 12 9 9 9 12 13 0 0 0 0 8 9 10 0 0 0 0 0 0 0 1 3 0 8 10 0 11 13 0 0 0 0 11 13 0 0 8 10 1 2 3 0 0 0 0 1 2 2 2 2 2 2 
1 2 3 0 11 13 0 0 0 8 9 10 0 0 0 0 0 11 12 9 9 9 12 13 0 0 0 0 0 8 9 10 0 0 0 0 0 0 8 9 10 0 0 0 0 0 0 0 8 10 0 11 13 0 0 0 0 0 0 0 0 0 0 0 11 13 8 9 10 1 3 0 0 8 9 9 9 9 9 9 
11 12 13 0 0 0 0 0 0 8 9 10 0 0 0 0 0 0 0 8 9 10 0 0 0 0 0 0 0 8 9 10 0 0 0 0 0 0 8 9 10 0 0 0 0 0 0 0 11 13 0 0 0 0 0 0 0 0 0 0 0 0 0 0 0 0 8 9 10 8 10 0 0 8 9 9 9 9 9 9
